21 101
**---------------------------------------------------------------------------------------------------
**************-*****-***-***-***-***-*******-*****-*************-*******-***-*-*-***-*******-*-*-**#-
---*---*-----*-*-*-*-*-*-*---*---*-*---*-*-------*-*-*-----*-*---*---*---*---*-*---*-----*-*-*-*---*-
-*****-*-*******-*-***-***-***-*-*-*****-*-***-*-***-*-*****-***-*-*-*******-*****-*****-*-*********-
-----*-----*-------*-*---*---*-*-*-----*---*---*---*---*---*-----*-*---*-*-*-*---------*-*---*---*-*-
-*****-*********-*-*-***-***-*******-*-*-***-*-***-*-*****-*-*******-***-*-***-***-*******-***-***-*-
---*-*-----------*---*-------------*-*---*---*-*-*-*-------*---*-*-*-*---*-*-*-*-----*-----*---*---*-
-***-*-*****************-***************-***-***-*-*-*-*********-*-*-***-*-*-***-*****-*******-***-*-
-*-----*-*-----*-*-------*-*-----*-----*-*-*-*-----*-*-*-----*---*-*---------*---*-*-----*-*-------*-
-*****-*-*-*-***-*******-*-*-*****-*-*****-***-***-*-***-*****-*-*-*******-*-*****-*-*****-*******-*-
---*-----*-*---*-----*-*-*---------*-------*-*---*-------*-*-*-*-*---------*-*-*---*-*-----*-----*-*-
-*******-***-*******-*-*****-*-***-*********-*-***-*****-*-*-*-***-*-*-***-***-***-*-*-*******-***-*-
-*-*---------------*-----*---*-*-*---*-*-----*---*-*-*-----*-----*-*-*-*-----*---------*-----*---*---
-*-*-*-*-***-*******-*-*********-***-*-***-*******-*-*-***-*-*-*-***-*-*-*-*****-*-*-*****-***-*****-
-----*-*---*---*-*-*-*-*-----------*-------*-----*-*---*---*-*-*-----*-*-*-*-----*-*-*-*---------*-*-
-*****-*********-*-*-*-***-***-*-***-*****-*-*-***-*******-*-***-*************-***-***-*-***-***-*-*-
-*---*-*-*-*---*-----*---*-*---*---*-*-----*-*-----*---*-*-*-*-------*-*-----*-*---*---*---*---*---*-
-$-*****-*-*-*-*-*-***-***-*-*-*-*-***-***-*-*-***-*-***-***-***-*-*-*-***-*-***-***-*-***-*-*-***-*-
---*-*---*-*-*-*-*-*---*---*-*-*-*-*---*---*-*-*-*-*---*-----*---*-*---*-*-*-------*-*---*-*-*-*-*-*-
-***-***-*-***-***-*********-***********-*******-***-*************-*****-***-***********-*-*****-****
---------------------------------------------------------------------------------------------------**