34 60
**-----------------------------------------------------------
******-*********-*-***-***-*-*********-*-***-***-********$**-
-----*---*-------*-*-*-*---*-*---*-----*---*---*-*-*---*-*---
-*******-*-*********-*-*-***-*-***-***-***-*-*****-*-***-***-
-*-*---*-*-*-----*-----*-*-----*-*-*-----*-*-*-----*-*-----*-
-*-*-*********-*-*******-*******-*****-*-***-*-*-***-*-***-*-
-----*-------*-*---*-----*-*---*-*-*-*-*---*-*-*-------*---*-
-***-*-*-*********-*-***-*-*-*-*-*-*-*******-***-*-*-*******-
-*-*-*-*-*-------*-*-*---*---*---------*-----*-*-*-*---------
-*-*-*-***-*-*-***-*-***-***-*-***-***-*-*****-*-*-*****-***-
-*-*-----*-*-*-*-*-*-*-----*-*---*---*-*-----*---*---*-----*-
-*-*****-*-*-*-*-*-*****-***-*-*-*****-*-***************-***-
-*-*-*-*-*-*-*-----*-*-*---*-*-*---*---*-----*---*-*---*-*-*-
-*-*-*-***-*-***-***-*-***-*****-***-*-*-*-*****-*-***-*-*-*-
---------*-*-*-*-*-*---*-*-*-------*-*-*-*-*---------------*-
-*-*****-*-***-***-***-*-*-*-*****-*-*****-*************-***-
-*-----*---*---*-----*-------*-----*---*-*-*-*-------*-----*-
-*****-***-*-*-*-*****-*-***-*-*-*-***-*-***-***-*******-***-
-*-------*-*-*-*---*---*---*-*-*-*-*---*-------------*---*---
-***-*****-***-*-***-*-*****-***-*-*-*******-***-*-***-*****-
-*-*-*-*-*---*-*---*-*---*-----*-*-*---*-*-----*-*-------*---
-*-*-*-*-***-*-*-*******-***-*-*******-*-*-***-*********-*-*-
-*---*---*---*-----------*---*---*---*-*-*-*-*-------*---*-*-
-***-*-***************-*************-***-***-*****-*-***-***-
-*---------*-----*-------*---------------*---*---*-*---*-*-*-
-***-***-*******-*-*****-*-*******-***-***-***-*-*******-*-*-
-*-----*---*-*-------*-------*-----*-*-----*---*-*-------*-*-
-*******-***-*****-*-*******-***-***-*-***-*****-*-*-***-*-*-
-*---*---*-*-*-----*---*---*-*-----*-*---*-----*---*-*-*---*-
-*-***-***-*-*-***********-*******-*-*******-*****-***-*****-
-*-*---*---*---------------*---------*-------*-----------*---
-*-*-***-*****-***-***-***-*-*-*******-***-#-*********-*-***-
-*-----*-----*-*-*-*-----*-*-*-----*-*---*-*-*---------*-*---
-*-***-***-*****-*-*******-*-*******-*-***-***-*-***********