50 49
**-----------------------------------------------
**-***********-*****-*********-*****-*****-******
-*-*-----*-------*-*---*-----*-*---*---*---------
-*****-*-*-***-*-*-***-***-***-***-$-*****-*****-
-*-----*-*---*-*---*-------*-*-*-----*-------*---
-*-***-*********-***-*****-*-*-*********-***-***-
-*-*---------------*-*-------*-*-----*-*-*-*-*----
-*****************-*******-*-*****-*-*-***-*-***-
---*-*-------*---*-*-*---*-*---*---*---*---*-*-*-
-***-*****-*-*-*-***-*-*-*-***-*-*****-***-*-*-*-
-*---------*-*-*-*-*---*-*-*---------*---*---*---
-*******-*******-*-*-*********-*******-*****-****
-------*-------------*-*-*-----*---*-*---*-*-*-*-
-***-*-*****-***-*-*-*-*-*-*****-***-*-***-***-*-
-*-*-*---*---*---*-*-----*---*-------*---*---*---
-*-*****-*-*-***-*******-***-*-***-*******-*****-
-*---*-*---*-*-*-----*---*---*---*---------*-----
-*-*-*-*-*-***-*-*****-*-*-***-***-***-*****-****
---*-*---*-*-----*-----*-*-*---*-*-*-----*-*---*-
-***-*****-***-*-*-*******-*-***-***-*-***-*****-
---*-*-*---*---*-*-*-----*-----*---*-*-*-----*---
-*-*-*-*********-*****-***-*-***-*-***-*-********
-*-*---*---*---------*-*---*-*-*-*-*---*---*-----
-*****-*-*-***-***-***-*-*****-*-*-*-*-*-***-***-
-*-*---*-*---*---*-*---*-*-----*-*---*-*-*-*-*---
-*-***-*****-*-*****-***-*-*******-*-*-*-*-*****-
-*-*---*---*---*-----*---*---*-----*-*-*-*-*---*-
-*-***-*-***-*-*****-***-*-***-***-***-*-*-*-*-*-
---*-----*---*-----*-------*-----*-*-*-*-*---*-*-
-***-***********-*******-*****-***-*-*-*-*-*-****
-*-----*---*-------*-*-----*---*-*---*---*-*-*-*-
-*****-*-***-*-*-***-*-***-*****-*-*******-*-*-**
-*---*-*-----*-*---*-----*-*-*-*---*-*-----*-----
-*-*-*-*****-***-*-*********-*-*-*-*-*******-****
-*-*-*-*-------*-*-----*---*-*---*-*-*-----------
-***-*****-*-*****-***-***-*-*******-***-***-****
-------*---*---*-----*-*-------*---*-----*---*---
-*********************-***-*-*-*-***-***********-
-*-------*-----------*---*-*-*-------------*---*-
-*-*-*****-*********-***-*-*****-***-*-*******-*-
-*-*-----*-----*---------*-*-----*---*-----*-*---
-***-*****-*-*-*-***************-*****-*-*-*-*-*-
-*---*-----*-*-*-----*-*-------*-*-*---*-*-*---*-
-*-*********-*********-***-***-***-*-*********-**
-*---*---------------*-----*-----*---*-------*-*-
-*-*********-*-*-#-*****-***-*****-***-***-*-***-
-*-*---*---*-*-*-*-----*---*-----------*-*-*-*-*-
-*-***-***-***-***************-***-*****-*****-*-
---*---------*-*---*-----*-----*---*-------*-*---
-*****-*****-***-***-*****-*****-*****-*****-*-*-